STAGE,WAITING,DEFINING,SOLVING,TRANSFERRING,RESOLVING,FOLLOWING-UP,CLOSED
0,5,8,10,5,8,8,0
1,64,97,129,64,97,97,0
2,104,156,208,104,156,156,0
3,130,195,261,130,195,195,0
4,148,222,296,148,222,222,0
5,160,239,319,160,239,239,0
6,167,251,335,167,251,251,0
7,173,259,345,173,259,259,0
8,176,264,352,176,264,264,0
9,178,268,357,178,268,268,0
10,180,270,360,180,270,270,0
